NO			   	./textures/north.xpm	  
SO				./textures/south.xpm
WE	./textures/west.xpm
EA	      	./textures/east.xpm
F	22,100,0
C	225      ,30,        50
        1111 111111111111111111111       
        10001 10000110000000000001
        1011010001110000000000001
        1001000000000000000000001
111111111011000001110000000000001
100000000011000001110111110111111
11110111111111011100000010001
11110111111111011101010010001
11000000110101011100000010001
10000000000000001100000010001
10000000000000001101010010001
1100000111010101111011110N0111
11110111 1110101 101111010001
11111111 1111111 111111111111