  




                        WE                   ./textures/west.xpm
   
   NO ./textures/north.xpm

C  0, 1  ,1 

SO                ./textures/south.xpm

EA ./textures/east.xpm

F   67,  1 ,2

11111111111111111111111                            
10000000000000000000001
100000000000000000000011
100000000000000000000001
100000000000000000000001
100000000001000000000001 
100000000010000000000001
100000000000000000000001
100000111110000101010001
100000100010000000000001
100000100010000100010001
100000100010000000000001
100000111100001010100001
100000000000000000000001
100000000000000000000001
100000000000000000000001
100000000000000000000001
100000000000100000001001
100000000000000000000001
100000000000000000000001
111111111000000000000001
100100001000000000000001
1010S0101000000000000011
100100001000000000000001
100111111000000000000001
100000000000000000000001
100000000010000000000001
111111111111111111111111